W,S,W,W,W,W,W,W,W,W,W,W,W,W,W,W,W,W,W,W
W,P,W,W,W,W,W,W,W,W,W,W,W,W,W,W,W,W,W,W
W,P,W,W,W,W,W,W,W,W,W,W,W,W,W,W,W,W,W,W
W,P,W,W,W,W,W,W,W,W,W,W,W,W,W,W,W,W,W,W
W,P,W,W,W,W,W,P,P,P,P,P,P,P,P,P,P,W,W,W
W,P,W,W,W,W,W,P,W,W,W,W,W,W,W,W,P,W,W,W
W,P,W,W,W,W,W,P,W,W,W,W,W,W,W,W,P,W,W,W
W,P,W,W,W,W,W,P,W,W,W,W,W,W,W,W,P,W,W,W
W,P,W,W,W,W,W,P,W,W,W,W,W,W,W,W,P,W,W,W
W,P,W,W,W,W,W,P,P,P,P,P,W,W,W,W,P,W,W,W
W,P,W,W,W,W,W,W,W,W,W,P,W,W,W,W,P,W,W,W
W,P,W,W,W,W,W,W,W,W,W,P,W,W,W,W,P,W,W,W
W,P,W,W,W,W,W,W,W,W,W,P,W,W,W,W,P,W,W,W
W,P,W,W,W,W,W,W,W,W,W,P,W,W,W,W,P,W,W,W
W,P,W,W,W,W,W,W,W,W,W,P,W,W,W,W,P,W,W,W
W,P,P,P,P,P,P,P,P,P,P,P,W,W,W,W,P,W,W,W
W,W,W,W,W,W,W,W,W,W,W,W,W,W,W,W,P,W,W,W
W,W,W,W,W,W,W,W,W,W,W,W,W,W,W,W,P,W,W,W
W,W,W,W,W,W,W,W,W,W,W,W,W,W,W,W,P,W,W,W
W,W,W,W,W,W,W,W,W,W,W,W,W,W,W,W,F,W,W,W
